year;data_pop;ygr;gr;duration
1177;74.0;1.0012185441526111;1.0284054065045198;23
1200;76.10200008133428;1.0012185441526111;1.011020504232137;9
1209;76.94068249530469;1.0012185441526111;1.012252477355739;10
1219;77.8833964653134;1.0012185441526111;1.0221624599778045;18
1237;370.60948412241123;1.0009280685191946;1.0121323021683528;13
1250;1775.1065050066236;1.0012821211336682;1.0233314151961042;18
1268;2517.9153740878082;1.003367796700188;1.0101374544621393;3
1271;2548.548725353356;1.0034181904249841;1.0172081924480347;5
1276;2893.7750704584255;1.0030912618794396;1.0061920796588866;2
1278;4491.735150767118;1.0026155599037279;1.0131463902233393;5
1283;4699.671825566384;1.002672284338338;1.0464131225363462;17
1300;9080.805895988191;1.003305321501721;1.0066215681536717;2
1302;9501.051788004926;1.0031921438927287;1.025824293868464;8
1310;9818.946261555964;1.0032441701073445;1.009764118384811;3
1313;12981.204449905024;1.0040036589201036;1.0660184674868471;16
1329;14764.083655613578;1.0032459545174464;1.0032459545174464;1
1330;14930.007199651473;1.0031977684249058;1.0193406519532895;6
1336;15346.049348641558;1.0034661754880119;1.0034661754880119;1
1337;15715.241448731631;1.0033894102382641;1.0033894102382641;1
1338;15768.506848994759;1.002700245250933;1.002700245250933;1
1339;16379.085684728067;0.9983172806476511;0.9983172806476511;1
1340;16690.52428027259;0.9985259684414408;0.9955844204286992;3
1343;16629.733368736248;0.998934605806396;0.9925660347251793;7
1350;17943.852652894002;1.0002130933552302;1.0004262321192385;2
1352;18220.250732830966;1.0004068204116257;1.0004068204116257;1
1353;19327.663102734008;1.0005899338232218;1.0005899338232218;1
1354;19497.065144922155;1.0006849782687712;1.0006849782687712;1
1355;19930.420210851244;1.0005792708000054;1.0005792708000054;1
1356;20153.96532131123;1.0013385425098096;1.0040210050158418;3
1359;20237.497952991183;1.0014872809619213;1.0044684821896155;3
1362;20330.33947385863;1.0016053052314875;1.0032131874678611;2
1364;20396.450904861562;1.0016358954178497;1.0065596561131005;4
1368;20534.85130356916;1.0017559143905754;1.0123563384957943;7
1375;20977.280481520997;1.00199748098306;1.006004420709823;3
1378;21105.37931074649;1.0020985909992597;1.0020985909992597;1
1379;21149.670869803973;1.0013003694222293;1.0013003694222293;1
1380;22577.173255093283;1.0010392026469568;1.002079485236055;2
1382;23414.773461869387;1.0008857815805101;1.0062169721990317;7
1389;23609.426999493568;1.0010899373858695;1.0032733773429297;3
1392;27688.657621999315;1.0008519919209657;1.00255815405205;3
1395;28600.457810399836;0.9999153627892804;0.9999153627892804;1
1396;28830.03714742545;0.9999441779964574;0.9997767306817104;4
1400;34359.94685611691;1.0004134683799724;1.0004134683799724;1
1401;34463.15360767946;1.0004696595958738;1.0004696595958738;1
1402;34844.33955847537;1.000816847632534;1.000816847632534;1
1403;34981.802074750914;1.0005723321563118;1.0005723321563118;1
1404;35149.82328496404;1.0006017198376413;1.0012038017420457;2
1406;35307.26544003302;1.0006676304940911;1.0006676304940911;1
1407;35330.83764710377;1.001243388309373;1.001243388309373;1
1408;35374.76759759453;1.0012547105137446;1.0012547105137446;1
1409;35690.15269042051;1.0012580666183635;1.0025177159683432;2
1411;35780.41210189056;1.0012805354760426;1.0012805354760426;1
1412;37249.23018893446;1.0010344729550227;1.0010344729550227;1
1413;37591.76351016032;1.0010463986289968;1.0010463986289968;1
1414;38016.09947995893;1.0010612614316683;1.002123649139163;2
1416;52615.37640462176;1.000309666176261;1.000309666176261;1
1417;54280.6696070455;1.0001316241624285;1.0003949244643264;3
1420;54498.83127698251;1.0002069932450735;1.0004140293363504;2
1422;54522.61121452703;1.000337726636292;1.0010135221252396;3
1425;54681.33012701063;1.0004332697432998;1.0013003724792453;3
1428;55763.81423770069;1.000450371492399;1.000450371492399;1
1429;55857.92866994079;1.0004712108767337;1.0004712108767337;1
1430;55899.24953348189;1.0004946539955226;1.0009895526736206;2
1432;56457.657213340404;1.0005566579300575;1.0005566579300575;1
1433;56592.08481594069;1.0005796191087286;1.0011595741757684;2
1435;56658.78470841682;1.0006175312157888;1.0006175312157888;1
1436;56885.77327662293;1.0006422293271617;1.0006422293271617;1
1437;56957.306988519456;1.0006647413078438;1.0039950819398187;6
1443;57380.5477104609;1.000718176975575;1.000718176975575;1
1444;58216.75709867243;1.0007682632620076;1.0007682632620076;1
1445;58457.482894384564;1.0007300192389794;1.0036554293676878;5
1450;61397.36750122292;1.0002047113241912;1.0004094645551087;2
1452;61472.36488385241;1.0003635244511997;1.0003635244511997;1
1453;65152.71159156075;1.0005968203098736;1.0005968203098736;1
1454;65498.596053081936;1.000639058159715;1.0012785247147618;2
1456;67907.66763343147;1.0008100278925582;1.0024320526447308;3
1459;68715.98225131043;1.0008589087157838;1.0008589087157838;1
1460;69161.00300737974;1.0008815225815875;1.0026468996759634;3
1463;69730.26433448006;1.000916964648363;1.000916964648363;1
1464;69927.20452179578;1.0009403241188048;1.0009403241188048;1
1465;70277.95875876823;1.0009571248415803;1.001915165771123;2
1467;83757.96945256142;1.0011988716786862;1.0011988716786862;1
1468;85419.38451000235;1.0013503118439138;1.0027024470299033;2
1470;87027.09462342273;1.0017894479553198;1.0071770274955782;4
1474;87775.19248496028;1.0018450667585985;1.0036935377885408;2
1476;88154.15199846424;1.0018983632805405;1.0076151031991771;4
1480;88830.18118608554;1.0020603239809733;1.0020603239809733;1
1481;89406.20013861742;1.0020545439566069;1.0020545439566069;1
1482;89589.8891067954;1.0020659982951914;1.0020659982951914;1
1483;89774.9816649564;1.0020940306428272;1.008402469105534;4
1487;90589.42238075014;1.0021358759087853;1.0021358759087853;1
1488;91508.91014560394;1.0021331319494804;1.0021331319494804;1
1489;91704.11072549764;1.002142580861931;1.004289752376612;2
1491;92098.36948561024;1.0021615595950573;1.013039644987155;6
1497;94888.66038572538;1.002295439558159;1.004596148159083;2
1499;95325.72648854172;1.0023238985565848;1.0023238985565848;1
1500;99630.25380673385;1.0022829413559557;1.0045710945331463;2
1502;100086.64191331624;1.0023014279928861;1.0185604125149195;8
1510;102472.24995643423;1.0023816741717748;1.00476902071541;2
1512;102961.96412007118;1.0024077926836634;1.0120970778334788;5
1517;104217.99471230773;1.0024616824070423;1.0024616824070423;1
1518;105275.54631638824;1.002478273560062;1.0049626889599623;2
1520;105799.06375011221;1.0029937774882844;1.0120289935847258;4
1524;107139.60311874216;1.0030502820781881;1.0122570672458515;4
1528;108461.97785333652;1.0030806784549244;1.0030806784549244;1
1529;109443.11433168779;1.003139670475446;1.003139670475446;1
1530;110224.72964649586;1.0031863402394958;1.0031863402394958;1
1531;113225.94313795608;1.003223792372818;1.003223792372818;1
1532;113590.96006984939;1.0032429285022977;1.0097603693672401;3
1535;116204.5384511807;1.0033136710202193;1.0033136710202193;1
1536;116604.60206266437;1.0033286006153785;1.013381027594626;4
1540;118175.11206246157;1.0033043288993975;1.0099457785452293;3
1543;119575.63619154328;1.0033545024402075;1.0237191490920001;7
1550;127018.03505306544;1.003069155233985;1.012333254950029;4
1554;130785.81552864771;1.0030691935136784;1.0030691935136784;1
1555;131451.22250534935;1.0030792058218605;1.0061678931522144;2
1557;132313.278018918;1.0030990974262577;1.0030990974262577;1
1558;134417.32975828613;1.0031071861345995;1.0031071861345995;1
1559;135012.98942156092;1.0031188324280504;1.0031188324280504;1
1560;136084.07231117692;1.0030785068131758;1.0061664908305503;2
1562;136973.5523775102;1.0030953388591854;1.0062002588410242;2
1564;137824.15925535938;1.0031139966278424;1.006237690230683;2
1566;138685.2131677704;1.0031352167678127;1.0031352167678127;1
1567;145314.02137354173;1.0028994540214955;1.0028994540214955;1
1568;146041.35269719287;1.0029165893988323;1.005841685291386;2
1570;147284.0999285649;1.0029472079055215;1.0029472079055215;1
1571;148260.17679223197;1.0029519984777728;1.0088821640429424;3
1574;153707.4643323744;1.00301242744709;1.0121042675331862;4
1578;157595.55255091804;1.0030003922415522;1.0030003922415522;1
1579;158249.401024095;1.0030084142907905;1.0030084142907905;1
1580;159555.48078364495;1.0030292134529861;1.0030292134529861;1
1581;160260.8083925324;1.003040861284967;1.003040861284967;1
1582;160748.13928027076;1.0027619080927506;1.0027619080927506;1
1583;161690.11086704358;1.0026097962184963;1.0026097962184963;1
1584;162112.08910695263;1.0025701932660958;1.0025701932660958;1
1585;163786.74850672798;1.002603514334511;1.002603514334511;1
1586;165225.1696542682;1.0026265418323173;1.0052599823866315;2
1588;166348.72997397813;1.002663737816709;1.002663737816709;1
1589;166791.83937677127;1.002681992552409;1.002681992552409;1
1590;167540.17384778234;1.0027229860215257;1.0027229860215257;1
1591;197440.38339921378;1.0017245384672726;1.0086524839981954;5
1596;201269.98116932533;1.001928420370107;1.001928420370107;1
1597;203068.11430090334;1.0023454342296336;1.0023454342296336;1
1598;203584.39720713178;1.0023615021311107;1.0023615021311107;1
1599;206663.16219499728;1.0023423638888105;1.0023423638888105;1
1600;212085.24252327014;1.0019467164599705;1.0019467164599705;1
1601;212498.11235580704;1.0019826832995489;1.0019826832995489;1
1602;216742.42881436052;1.0019293018880244;1.0019293018880244;1
1603;217160.5903914871;1.0019564783103116;1.0117964369729466;6
1609;219799.87355096173;1.002076239543646;1.002076239543646;1
1610;222091.23074011662;1.0020860874705524;1.0020860874705524;1
1611;223739.5324738831;1.0021020335594186;1.0042084856639222;2
1613;224685.94812716395;1.0021470397933188;1.0042986893665116;2
1615;225656.55804310436;1.0021891094083797;1.0087852328190956;4
1619;227667.20454275317;1.0022732379828168;1.0022732379828168;1
1620;228184.7462795615;1.0017106743218605;1.0017106743218605;1
1621;230627.0960656622;1.0017692951043284;1.003541720613823;2
1623;233462.38454481258;1.0018182774986006;1.005464756906455;3
1626;236213.97385798203;1.0019999587462378;1.0040039173274622;2
1628;237167.68964126342;1.0020665398033792;1.0020665398033792;1
1629;239499.8061119826;0.9992611777374886;0.9992611777374886;1
1630;240119.85832335986;1.0024405394389924;1.0024405394389924;1
1631;241549.88030768337;1.0024719186359203;1.0024719186359203;1
1632;242836.97195832027;1.0024946929235858;1.0024946929235858;1
1633;243521.77563384973;1.0025220725540083;1.0025220725540083;1
1634;264376.9552204792;1.002727567953733;1.002727567953733;1
1635;265939.0613312441;1.0027823183611833;1.0027823183611833;1
1636;266792.98846454185;1.0028216855259449;1.0028216855259449;1
1637;268719.7943785157;1.0028085725509666;1.0028085725509666;1
1638;269474.5134169086;1.0028630082155316;1.0028630082155316;1
1639;270922.02116269764;1.0029244816454577;1.0029244816454577;1
1640;272281.3276409382;1.0034916490838224;1.0034916490838224;1
1641;273427.03848913766;1.003514615428551;1.0070415833787127;2
1643;281947.37150993943;1.0035242983680002;1.007061017414987;2
1645;284442.5121290711;1.0035583284922192;1.0107130156361268;3
1648;287727.40206397045;1.0036207474505257;1.0036207474505257;1
1649;288769.19032143994;1.003617957710125;1.003617957710125;1
1650;294710.9450400101;1.003283270831693;1.0065773215307403;2
1652;297414.79784609715;1.0033227558945375;1.0033227558945375;1
1653;302540.03461876296;1.0033560590162682;1.0033560590162682;1
1654;303555.3768297274;1.00332239499874;1.0066558283060076;2
1656;305760.25259767374;1.0033482042100568;1.0033482042100568;1
1657;306784.00036268926;1.0033689455175663;1.0033689455175663;1
1658;308867.5389455723;1.0033767978075667;1.0033767978075667;1
1659;309910.5221739122;1.0033935166504997;1.0033935166504997;1
1660;313076.2086910746;1.0033990142134535;1.0033990142134535;1
1661;314140.35917430965;1.0034133809876902;1.0068384131451475;2
1663;316293.21625841485;1.0033657254903547;1.0033657254903547;1
1664;317927.772398802;1.003355718192753;1.003355718192753;1
1665;319415.648408622;1.0033690710325944;1.0033690710325944;1
1666;321576.78241703287;1.0033784291803327;1.0033784291803327;1
1667;342483.2068024682;1.003462351460472;1.003462351460472;1
1668;343669.0040337279;1.003451728948372;1.003451728948372;1
1669;347134.2562836093;1.0034341355506817;1.0034341355506817;1
1670;351877.36237397237;1.0032940621260473;1.0032940621260473;1
1671;355650.46826638177;1.0032898660200322;1.0032898660200322;1
1672;356973.5106569399;1.0032069378839186;1.0032069378839186;1
1673;358618.30253182095;1.0032229831466266;1.0064563539136167;2
1675;361178.3576833593;1.0032339914457926;1.0064784415922567;2
1677;363700.9542946447;1.0032531986174174;1.0032531986174174;1
1678;367627.14573630935;1.0032676817530632;1.006546041250166;2
1680;373897.6125128112;1.0032515657476408;1.0032515657476408;1
1681;375113.3651827826;1.0032695334683666;1.0032695334683666;1
1682;377753.81088467914;1.0032645629949122;1.0032645629949122;1
1683;380700.0119968803;1.0032038477932421;1.0032038477932421;1
1684;382982.7168902037;1.0032091672243253;1.0032091672243253;1
1685;385272.77247273084;1.003206594212724;1.006423470671893;2
1687;389321.0672689558;1.0032353380386785;1.0064811434895815;2
1689;393497.8731861497;1.00309088173602;1.00309088173602;1
1690;395829.1285755435;1.0031107295652384;1.0031107295652384;1
1691;397460.445948586;1.0031059279005814;1.0031059279005814;1
1692;400434.9294370353;1.0030808996892446;1.0030808996892446;1
1693;402077.6292867005;1.0030976632808104;1.0030976632808104;1
1694;403323.1303949772;1.0031110868127857;1.0031110868127857;1
1695;428605.90366724064;1.0030805461311614;1.0030805461311614;1
1696;429926.24392557563;1.0031000838150026;1.0031000838150026;1
1697;431259.0513160141;1.0031169232025963;1.0031169232025963;1
1698;434213.2526593906;1.0031527432716276;1.0031527432716276;1
1699;437419.2155701639;1.003138354103046;1.003138354103046;1
1700;440149.9919600996;1.0031670160106048;1.0031670160106048;1
1701;443171.9540317049;1.0031378385269707;1.0031378385269707;1
1702;444562.55606313853;1.00314698625669;1.00314698625669;1
1703;446061.5883173082;1.0031239146485964;1.0031239146485964;1
1704;448284.0466472288;1.00315786835945;1.0095035529667586;3
1707;452563.00036586897;1.0031905839164001;1.0031905839164001;1
1708;454006.94059599406;1.0031938804995766;1.0031938804995766;1
1709;456587.984510236;1.0031544295816974;1.0031544295816974;1
1710;458243.2591552227;1.0032075555913451;1.0064253995955619;2
1712;461193.84099778347;1.0032407197825048;1.0032407197825048;1
1713;463620.4410018744;1.0032311908698697;1.0064728223341768;2
1715;467306.71838074806;1.003256768970232;1.0098021610861365;3
1718;471906.69728137116;1.0032988191898382;1.0032988191898382;1
1719;473744.4321501761;1.0032161142997695;1.0064425719907282;2
1721;476803.9437996183;1.0032460124099651;1.0032460124099651;1
1722;480821.65531831194;1.003183102542557;1.003183102542557;1
1723;482352.1599518723;1.0032210159436827;1.006452406831075;2
1725;486290.9317328729;1.0032526471035177;1.0032526471035177;1
1726;488363.6645234407;1.003260822734169;1.003260822734169;1
1727;489956.13186326093;1.0032708555448946;1.0065524095857847;2
1729;493174.07019986055;1.0033043830968613;1.0033043830968613;1
1730;497045.70626123936;1.003304684845514;1.0066202906329562;2
1732;500379.97990760475;1.0033353393149556;1.0033353393149556;1
1733;502529.91692700726;1.0033340515933504;1.0033340515933504;1
1734;507842.3775972439;1.003112413060874;1.0062345132368093;2
1736;512076.54930161807;1.0031469845953613;1.0063038727027662;2
1738;515920.67802058207;1.003170979781022;1.003170979781022;1
1739;534911.6520591966;1.0032391533633818;1.006488798841275;2
1741;538549.9614944821;1.003274901378841;1.003274901378841;1
1742;540382.659505955;1.0032954172419692;1.0032954172419692;1
1743;566153.445839352;1.003273047558736;1.003273047558736;1
1744;571254.4929931265;1.0032689224615292;1.0032689224615292;1
1745;578432.8796365209;1.003230705470244;1.003230705470244;1
1746;580301.6259049317;1.0032528325774783;1.0032528325774783;1
1747;582334.2499384389;1.0032663142219467;1.0032663142219467;1
1748;584399.3365809395;1.0032806750464762;1.0032806750464762;1
1749;586316.5609016378;1.003292533621515;1.003292533621515;1
1750;598456.0278912574;1.003125507735541;1.0094058601348934;3
1753;604630.8340794394;1.0031830006027116;1.00637613269826;2
1755;611351.002185503;1.003249700404627;1.003249700404627;1
1756;613337.7097846745;1.0032537370933143;1.006518060991701;2
1758;618025.533034477;1.0033085352298983;1.006628016865164;2
1760;622475.7810185697;1.0033338976772015;1.0033338976772015;1
1761;625066.0515790217;1.0033655519435873;1.0033655519435873;1
1762;628009.7438437839;1.0033468140825652;1.0033468140825652;1
1763;630111.5756984684;1.0033962079155532;1.0033962079155532;1
1764;863638.565619538;1.0046095329676936;1.0046095329676936;1
1765;868328.5360599324;1.0046300303215894;1.0046300303215894;1
1766;872348.9235109912;1.0045628496926828;1.0045628496926828;1
1767;876913.3205285455;1.0045824421702951;1.0045824421702951;1
1768;889532.7251082294;1.0046366575893724;1.0046366575893724;1
1769;894687.1837690974;1.0045763693027077;1.0045763693027077;1
1770;908829.6027324243;1.0046325047822606;1.0046325047822606;1
1771;922201.7602133423;1.0046603974734085;1.0046603974734085;1
1772;927066.5869666134;1.0047094333355109;1.0047094333355109;1
1773;931845.5452555122;1.0047330217047525;1.0047330217047525;1
1774;939277.9904466836;1.0047888474543274;1.0047888474543274;1
1775;943957.0494601399;1.0048162056971766;1.0048162056971766;1
1776;949029.34077964;1.0048466872885278;1.0048466872885278;1
1777;957882.9892220367;1.0049028337507109;1.0049028337507109;1
1778;962875.3302708262;1.004934285867211;1.004934285867211;1
1779;968312.4324048678;1.0050249989322861;1.0050249989322861;1
1780;978140.2013438216;1.0050878875708906;1.0050878875708906;1
1781;984593.8687168274;1.005136905925835;1.010300199654161;2
1783;995028.7468456365;1.0053180585202257;1.0053180585202257;1
1784;1001607.3679506687;1.0053401152761885;1.0053401152761885;1
1785;1006956.0667570047;1.005419911038069;1.005419911038069;1
1786;1012413.6790580717;1.005234275167909;1.005234275167909;1
1787;1018270.9308380167;1.0052744162497629;1.0052744162497629;1
1788;1025256.7155822897;1.0053103084169608;1.0053103084169608;1
1789;1031741.1449485918;1.005349355947916;1.005349355947916;1
1790;1038494.2955790323;1.0053734883692134;1.0053734883692134;1
1791;1044074.6325978206;1.0053476888705413;1.0053476888705413;1
1792;1049658.0188905785;1.004527362773796;1.004527362773796;1
1793;1055105.2015305206;1.0046114656000464;1.0046114656000464;1
1794;1063859.7828718089;1.0045965364329967;1.0045965364329967;1
1795;1070915.8531233794;1.0047628521416652;1.0047628521416652;1
1796;1076770.466987971;1.0048168097125136;1.0048168097125136;1
1797;1082623.0654315066;1.0048581067335987;1.0048581067335987;1
1798;1129985.563835629;1.0054508568847629;1.0054508568847629;1
1799;1162658.9534259445;1.0052518839870368;1.0052518839870368;1
1800;1187378.103365828;1.005493754320876;1.005493754320876;1
1801;1198846.2669517074;1.0057667208687662;1.0057667208687662;1
1802;1214612.6787377803;1.006199338938304;1.006199338938304;1
1803;1245554.4744120364;1.0062843843229585;1.0062843843229585;1
1804;1253856.017424422;1.0063526382231378;1.0063526382231378;1
1805;1262127.3110870237;1.0063832800624182;1.0063832800624182;1
1806;1270276.8231881193;1.0064368132781598;1.0064368132781598;1
1807;1278453.3579105553;1.0064684586286567;1.0064684586286567;1
1808;1290700.980564867;1.0065231425697185;1.0065231425697185;1
1809;1306368.407075967;1.006476206021414;1.006476206021414;1
1810;1315728.7180200573;1.0065135496612658;1.0065135496612658;1
1811;1366130.7823656332;1.0065252944722654;1.0065252944722654;1
1812;1375196.1880081953;1.006566050103332;1.006566050103332;1
1813;1384879.7950805682;1.0065295462180883;1.0065295462180883;1
1814;1393922.4317090432;1.0065974860409024;1.0065974860409024;1
1815;1403193.815494345;1.006677146358672;1.006677146358672;1
1816;1417353.1459699841;1.0063864320522133;1.0063864320522133;1
1817;1426404.9755307124;1.0064216238320336;1.0064216238320336;1
1818;1458848.8117157114;1.0066840082173667;1.0066840082173667;1
1819;1469766.769161115;1.0067082027724734;1.0067082027724734;1
1820;1479626.2626768912;1.0067311034602362;1.0067311034602362;1
1821;1490204.7801334513;1.0067521465596088;1.0067521465596088;1
1822;1500696.8612127418;1.0067717063696362;1.013589268746429;2
1824;1522849.0782792792;1.0068192149839121;1.0068192149839121;1
1825;1533233.713532118;1.0068418767712355;1.0068418767712355;1
1826;1544431.9096616087;1.0068654076486732;1.0068654076486732;1
1827;1578936.0643070552;1.0068911855106246;1.0068911855106246;1
1828;1589816.8056356108;1.0069142529694686;1.0069142529694686;1
1829;1600888.2012048876;1.0069458518696122;1.0069458518696122;1
1830;1614826.7335102675;1.0069952357384546;1.0069952357384546;1
1831;1641302.8271879307;1.0068762285972406;1.0068762285972406;1
1832;1652620.8006249724;1.0069030712632248;1.0069030712632248;1
1833;1664028.9597827743;1.006898294924174;1.006898294924174;1
1834;1676015.9223097216;1.0069217524274323;1.0069217524274323;1
1835;1696580.8895883844;1.0068837980663201;1.0068837980663201;1
1836;1715555.8098354884;1.0065096510992246;1.0065096510992246;1
1837;1752162.4795987657;1.0065188555163427;1.0065188555163427;1
1838;1766202.5736444273;1.0065858611285192;1.0065858611285192;1
1839;1777834.5385192833;1.0066812662325981;1.0066812662325981;1
1840;1789857.7243886387;1.006763585224277;1.0135729165336398;2
1842;1814291.6622996016;1.0068981459972077;1.0278794057393563;4
1846;1865669.910786325;1.0072171754539276;1.0144864385293881;2
1848;1892824.7860124721;1.0073527264843074;1.014759515555368;2
1850;2163196.767253982;1.003324850626098;1.0;0
